@@@@@@@@@
@.@.@S@.@
@.....@.@
@.@@@@@.@
@.......@
@.@@@.@@@
@.@.@...@
@...@.@G@
@@@@@@@@@